......G......
...X.....Y...
.X...X....X..
......Z......
X...X...X....
....Y......Y.
.............
T....T....T..
..D.D...D.D..
.C..C..C..C..
B.....B.....B
...A.....A...
......F......